111111111111111111111111111111
1P00000E0001111000000000000001
101000001000001000010111101111
111111111C000010000101111111C1
1C0000000000000Z0000C000000001
101111111100011100000111111111
10111110010111C011110111000001
1000001001000000000C0001111111
100000100000000000000000000001
111111111111111111111111111111