111111111111111111111111111111
100000000C00000000000000000001
100000111111000000111110C00001
100000001E01111000000010000001
101000001000001000000011111111
1010000000000010000000000C0001
101111C11C00001000011110000001
100000100000000001111000000111
100000100000011100000011111111
100000100P00000000000001000001
10000010000000C000001111000001
100000100000000000000000000001
100000000000000000000000000001
111111111111111111111111111111