11111111111111111111111
1E00000C000000C00000111
101001010010000101001
1101010010010000P111111
10000C000C000000C0111
11111111111111111111111