111111111111111111111111111111
100000000000000000000000000001
100000000010000000111110C00001
100000000000000000000010000001
101000000000000000000011111111
1000000000000000000000000C0001
100000C00000000000011110000001
100000111000000000010010000001
100000000000011100010011111111
100000000000000000000001000001
1000000000P000C000001111000001
100011100000000000000000111111
1000000000000000000000001000E1
111111111111111111111111111111