111111111
110000CP1
100011001
1000E0001
111111111