111111111
110000C01
100P11001
1000E0001
111111111